LEVEL 1:
000000000B0000L00000B0B0000000000000000MC00B0B0AK0000000000M
000000000B0000000000B0B0000000000000000MC00B0B0AK0000000000M
00U000000B0122600000l0B0000000000000000MC00B0B0AK0000000000M
013000040B000MC0000000B0000000000JJ00000B00B0B0AK0000000000M
0000000AKB000M72222230B0000000000GI00000B00B0B0AK0000000000M
0000000AKB00JMC0000000B0000000000000JJJ0B00BMC0AK0000000000M
0000000B0B01IMC0000000B00000000000017HI0B00LMC0AK0000000000M
0000000B0B000MC0000000B000000J000000AK00E000MC0AK0000000000M
00U0000B0B000MC0JJJJ00B000000G300000AK000000MC0AK0000000000M
0130000B0B0J0MC0GHHH22I0000000000000AK000000MC0AK0000000000M
0000000BMC0G3MC000000000000000000000AK000000MC0AK0000000000M
0000000BMI000MC000000000000000000000AK00000JMC0AK0000000000M
0000000B00000MC0000000000000000J0000AK000J0BMC0AK0000000000M
0000000B000J0MC00JJ0000J00JJ000G3000AK001I0B0G2I00000000000M
000000UB000G3MC01HH3001I00GI00000000AK00000B000000000000000M
0000045C00000MC000000000000000000000AK00000B000000000000000M
00000A7C00000MC000000000000000000000AK00000B000000000000000M
0000UA7C00000MC000000000000000000000AK00000B000000000000000M
5555577CJ55555755550JJJJJJJJ4560JJJJA56JJJ4760JJ455555555555
777777777777777777757777777777757777777777777577777777777777

LEVEL 2:
000000000M7K000000AK000000A00M7K0000000M7K00B000000000000000
000000000M7K000000AK000000E00M7K0000000M7K00B000000000000000
000000000M7K000000AK000000000M7K0000000M7K00B000000000000000
0000J0J00M7K00J0J0AK000012600M7K0000000M7K00B0J0000000000000
0000A2I00M7K00G2C0AK000000AK0M7K0080000M7K80LMC0000000000000
0460A0000M7K0000C0AK000000AK0M7K0000J0JM7K000MC0000000000000
0LL0A0000M7K0000CM7K0J0000AK0M723000G5IM7K000MC0000000000000
0000A0000M7K0000CM7KM755557K0M7K000007KM7KJ0JMC0000000000000
0000A00J0M7K0J00CM7K0LLLLLAK0M7K000007KM72C0A2C0000000000000
0000A22I00L00G22C0AK000000AK0M7K000007K0000000B0000000000000
0000A00000000000C0AK000000AK0M7K000007K0000000B0000000000000
0460A00000000000C0AK000000AK0M72300007K0000800B0000000000000
0LL0A000000000007KG2222300AK00L0000JJ7K0000000B0000000000000
0000A000J000J0007K00000000AK0000000777K0000000B0000000000000
0000A222I000G2227K00000000AK0000000777K0000000B0000000000000
0000A00000000000B000000000AK0000000777K0000080B0000000000000
0000A00000000000B000000000AK0080012777K0808000B0000000000000
0122I00000000000B000000000AK0000000LLAK0000000B0000000000000
0JJJJJJJJJJJJJJJBJJ456JJJ47KJJJJJJJJJAKJJJJJJJBJJJJJJJJJJJJJ
577777777777777777777777777577777777775777777777777777777777

LEVEL 3:
00000000000000000B00AHHHH7C0000B0000B00GHH77C0000M7K000000M7
00000000000000000B00E0000AC0000B0000AK0000LAC0000M7K000000M7
00000000000000000B0000000AC0000B0000AK00000LB0000M7K000000M7
00122300004222230B0000000LB0600B0000AK000000B0000M7K000000M7
0000000000B000000B00000000B0C00B000M7K046J00B0000M7K000000M7
0000000000B000000B00425300B0BJ0B000M7KM77CJ0B0000M7K000000M7
0000000000B000000B0JB0E000B0AI0B009M7K0A77C0B0000M7K000000M7
0000000000B012300B0GC00000B0B00B00BMC00A7CL0B00J0M7K000000M7
0012300000B000000B00B0122270B0MC0JBMC017C000B00AKM7K000000M7
0000000000B0000JJB00B00000A0B0MC0GC0B0M7C000B0JAKM7K000000M7
0000000000B0000GHC00B00000BKB00E00B0B0M7C00JB0A7KM7K000000M7
0000000000B0JJ000B00BJ0000BKB0JJ00AKB0M7L0JA7KA7KM7K000000M7
0000000000B0GI000GI0AH223MC0CM77K0AKB00B00A77KA7KM7K000000M7
0000000000B000000000B0000MC0C0LL00AKB00B01ILL0A7KM7K000000M7
5225230000B000000000B0000MC0B00000AKB00B000000A7KM7K000000M7
C00B000000B000000000B01222I0B00080AKG30B000000A7KM7K000000M7
C00B000000B0001300J0B0000000B00000B0000B00JJJ577KM7K000000M7
C00E000122C0000000A5C0000000B00000B0000B0JA77777K0L0000000M7
C000000000BJJJJJJJA7CJJJ0000BJ0JJ0BJJJ0B0A777777K000000000M7
755555555577777777777777555577577577775757777777555555555557

LEVEL 4:
70000000MC0000000M7K00000000000M7KB0000MC000000000000000000M
70000000MC0000000M7K00000000000M7KB0000MC000000000000000000M
70000000MC0000000M7K00000000000M7KL0000MC000000000000000000M
70000J00MC0125300M7300080080080M7K00J00M73000J0000000000000M
C000M7K0MC00M7K00M7K0J000000000M7K0M7K0MC0000AK000000000000M
C000M7K00L00M7K00M7KMC0JJJJJJJJJ7K0M7K0MC0000AK000000000000M
C0J0M7K0J0J0M7K00M7KMCM7777777777K8M70JMC00J0AK000000000000M
H2I0M7K0E0E0M7K00M7K1CMCLLLLLLLLL00M72IMC00G27K000000000000M
0000M7K00000M7K0JM7KMCMC00000000000M7K0MC000M7K000000000000M
0000M7K00000M7KMCM7KMCMC00000000000M7K0MCJ00M7K000000000000M
0000M7K00000M7K0LKL0MCMC000000000J0M7K00GI00M7K000000000000M
000017K00008M7K000001CMC00000000M7KM7K000000M7K000000000000M
0000M7K00000M7K00000MCMC0J0000000L0M7K000000M7K000000000000M
0000M7K00J00M7K80000MCMC0A000J0J000M7KJ0000JM7K000000000000M
0000M7K12I00M7K00J0JMC0L0A000G2I008M72I0J00G27K080000000008M
0000M7K00000M7K00G2IMC000A080000000M7K00G300M7K000000000000M
00000L0000000L000000MC000A000000000M7K0000000L0000000000000M
556000000000000000000L000L0000000000L0000000000000000000000M
77C0JJJJJJJJJJJJJJJJJJJJJJJJJJJJJJJJJJJJJJJJJJJJJJJJJJJJJJJJ
777577777777777777777777777777777777777777777777777777777777